11111
1C0C1
1P001
11111
1C0C1
1P001
11111
1C0C1
1P001
11111
1C0C1
1P001
11111
1C0C1
1P001
11111
1C0C1
1P001
11111
1C0C1
1P001
11111
1C0C1
1P001
11111
1C0C1
1P001
11111
1C0C1
1P001
11111
1C0C1
1P001
11111
