11111
1PL01
1E111
100C1
11111
