1111111111
1P00000001
10000000011111111111111111
1000000001
1000000001111111111111
1000000001
1000000001
1000000011
1000000E01
1111111111
