11111
1PCE1
11101
1C101
10101
10101
10101
10101
101C1
10001
101C1
11111
