11111
10000
11C11
100P1
1E001
11111
